UEEEEEEEEEUEEEEEEEEEU
QIIIIIIIIIHIIIIIIIIIW
QO3R1I3R1IHI3R1I3R1OW
QI4E2I4E2IDI4E2I4E2IW
QIIIIIIIIIIIIIIIIIIIW
UUUUUUUUUUUUUUUUUUUUU
UUUUUUUUUUUUUUUUUUUUU
UUUUUUUUUUUUUUUUUUUUU
UUUUUUUUUUUUUUUUUUUUU
UUUUUUUUUUUUUUUUUUUUU
UUUUUUUUUUUUUUUUUUUUU
UUUUUUUUUUUUUUUUUUUUU
UUUUUUUUUUUUUUUUUUUUU
UUUUUUUUUUUUUUUUUUUUU
UUUUUUUUUUUUUUUUUUUUU
UUUUUUUUUUUUUUUUUUUUU
UUUUUUUUUUUUUUUUUUUUU
UUUUUUUUUUUUUUUUUUUUU
UUUUUUUUUUUUUUUUUUUUU
UUUUUUUUUUUUUUUUUUUUU
UUUUUUUUUUUUUUUUUUUUU
UUUUUUUUUUUUUUUUUUUUU
